NO ./path_to_textures/north.xpm
SO ./path_to_textures/south.xpm
WE ./path_to_textures/west.xpm
EA ./path_to_textures/east.xpm

F 20,20,20
C 200,200,200

111111111111111111111111111111
100000000000000000000000000001
101111111110111111111111111001
101000000010100000000000001001
101011111010101111111111001001
101010001010101000000001001001
101010101010101011111001001001
101010100010001010001001001001
101011111111111010101001001001
101000000000000010101001001001
101111111111111110101111001001
100000000000000000100000001001
111111111111111111111111101001
100000000000000000000000101001
101111111111111111111100101001
101000000000000000000100101001
101011111111111111100100101001
101010000000000000100100101001
101010111111111100100100101001
101010100000000100100100101001
101010101111100100100100101001
101010101000100100100100101001
1010101010S0100100100100101001
101010101111100100100100101001
101010100000000100100100101001
101010111111111100101111111001
101000000000000000100000000001
101111111111111111111111111111
100000000000000000000000000001
111111111111111111111111111111
