NO textures/North.xpm
SO textures/South.xpm
WE textures/Wet.xpm
EA textures/East.xpm


C 5,255,8
F 0,0,0

        1111111111111111111111111
        1000000000110000000000001
        1011000001110000000000001
        1001000000000000000000001
111111111011000001110000000000001
100000000011000001111101111111111
11110111111111011100000010001
11110111111111011101010010001
11000000110101011100000010001
10000000000000001100000000001
100000000000000011010100W0001
1100000111010101111111100000111
11110111 1110101 101111010001
11111111 1111111 11111111111
