F 220,100,0
C 135,206,235

NO ./textures/north.xpm
SO ./textures/south.xpm
WE ./textures/west.xpm
EA ./textures/east.xpm

111111
100001
102001
1000N1
111111
