NO /home/oakhmouc/Cub3D/textures/North.xpm
SO /home/oakhmouc/Cub3D/textures/South.xpm
WE /home/oakhmouc/Cub3D/textures/West.xpm
EA /home/oakhmouc/Cub3D/textures/East.xpm


F 61,56,66
C 0,0,0


        1111111111111111111111111
        1000000000110000000000001
        1011000001110000000000001
        1001000000000000000000001
111111111011000001110000000000001
100000000011000001111101111111111
11110111111111011100000010001
11110111111111011101010010001
11000000110101011100000010001
10000000000000001100000010001
100000000000000011010100S0001
1100000111010101111111111000111
11110111 1110101 101111010001
11111111 1111111 111111111111
