NO ./path_to_the_north_texture
SO ./path_to_the_south_texture
WE ./path_to_the_west_texture
EA ./path_to_the_west_texture


F 255,100,0
C 225,225,225


        1111111111111111111111111
        1000000000110000000000001
        1011000001110000000000001
        1001000000000000000000001
111111111011000001110000000000001
100000000011000001111101111111111
11110111111111011100000010001
11110111111111011101001111101
11000000110101011100010000011
10000000000000001100010000011
100000000000000011010100W0011
1100000111010101111111000001111
11110111 1110101 101110000011
11111111 1111111 111111111111
