NO ./path_to_the_north_texture
SO ./path_to_the_south_texture
WE ./path_to_the_west_texture
EA ./path_to_the_west_texture


F 50,50,50
C 0,0,0


        1111111111111111111111111
        1000000000110000000000001
        1011000001110000000000001
        1001000000000000000000001
111111111011000001110000000000001
100000000011000001111101111111111
11110111111111011100000010001
11110111111111011101001111101
11000000110101011100011111111
10000000000000001100011010111
100000000000000011010111W0111
1100000111010101111111101011111
11110111 1110101 101111111111
11111111 1111111 111111111111
