sajh sa] sa
 sa sjajs ajs la
s a; s
a; sa;k slaks ;la sla 
sa lsk as 
as akl
 [ksal;k sa
1 0 kahskha ks1 00
111111111111111111
100000000000000001
1000000000000000001
1111111111111111111111
